Accursed Jerkin	Darkspire Punisher
Acolyte Boots	Psionic Acolyte
Actor's Cap	Periwinkle
Adaptive Helm	Adaptatron
Additional Deployment Drive	Dread Deployment
Adhesive Aquamitts	Aquamander
Adjudicator's Pendant	Silver Talon Adjudicator
Advanced Targeting Console	LZ-37 Targeting System
Aegis of Ogth	Murmurs From The Void
Aerodynamic Helm	War Bot Bunker
Ageless Scimitar	Ageless Troubadour
Air Shoe	Air Superiority
Airweight Bounders	Cloud Bounder
Alachian Lure	Alachian Angler
Alchemist Gloves	Ashwood Transmuter
Allgain	Power and Pain
Alluring Aegis	Heroic Outlaw
Alluring Pendant	Tantalizing Naiad
Alpaca Poncho	Llamafy
Alpha's Spear	Howling Plains Alpha
Ambush Leather	Snarling Ambusher
Ambush Treads	Ambush Guide
Amulet of Protection	Rhythmic Spiritualist
Amulet of the Ancients	Beseech the Ancients
Amulet of the Cuboid	Soul Cube
Amulet of the Healing Wind	Soothing Breeze
Amulet of the Sun	Sight of the Sun
Amulet of Yazukan	Yazukan
Ancestral Puzzle	Ancestral Ire
Ancient Gloves	Dance of Dusk
Ant Stake	Ants at a Picnic
Anti-Shrapnel Helmet	Samson, Lead Ballistics Engineer
Antimagic Helm	Countermagic
Anvil Strikers	Battlefield Ironsmith
Apex Cowl	Apex Forager
Apprentice Wizard Gloves	Apprentice Trio
Aqua Mask	Lightning Elemental
Arachnid Headwrap	Arachnomancer
Arachnid Wraps	Skitter of the Arachnid
Arc Transistor	Arc Amplifier
Arcanograft Arc	Arcanograft Technician
Archer's Longbow	Command Tower
Arctic Headgear	Arctic Emu
Ardent Chestplate	Ardent Recruiter
Ardent Cudgel	Caribaur Antlerguard
Arena Bracers	Arena Mutt
Armguards of Dread	Rot Sniper
Armor of the Diamond Citadel	Legionnaire of Adamanth
Armor of the Forest	Nerissa
Armor of the High Cleric	Xocoy, High Cleric
Armor of the Hired Horn	Hired Horn Sellsword
Armor of the Inky Depths	The Kraken
Armored Forelegs	Malevolent Mi'go
Arsonist's Sandal	Dream Skarn
Artificer's Mallet	Glendower
Ascended Crown	Holy Ascension
Ascus Axe	Bloom Burster
Ash Filled Fists	Return to Cinder
Ash Hood	Voice of the Ashwood
Ashbringer	From The Ashes
Ashwood Gloves	Ashwood Colossus
Ashwood Mace	Ashwood Smiter
Ashwood Tiara	Ashwood Colossus
Assailant's Boots	Deathmask Assailant
Assassin Sneakers	Monsuun, Shogun of Winda'jin
Augmentation Gloves	Subterranean Augmentor
Augmented Barrier	Subterranean Augmentor
Augur's Pendant	Brightmoon Augur
Auspicious Cowl	Deathless Agent
Auto-Defense Console	Barrier Bot
Autumn Leaf	Constantina
Avenger Platemail	Golden Avenger
Awakener's Bow	Necropolis Sharpshooter
Awakener's Stone	Exemplar of the Awakened
Axe Wielder Gloves	Axe Bot
Ayotochi Footwear	Fortress of Ayotochi
Azure Fang Bow	Webshot Sniper
Backstage Pass	Brosi's Bouncer
Badge of Oberon	Scion of Oberon
Badge of the Bloodsworn	Lazgar's Bloodsworn
Bait Switchers	Alachian Angler
Balance Scaled Sandals	Daarmak
Ball of Sinew	Tongue Breeder
Ballroom Slippers	Her Majesty, Queen Grace
Balthasar's Tears	Dream's End
Bandit Mitts	Daring Freebooter
Bandolier of the Assassin	Ninja Training
Bane of the Demon	Dark Pact Demon
Banner of Blood	Bloodlust
Banner of Gawaine	Crusader of Gawaine
Banner of the Ardent	For the Ardent!
Banner-bearing Handwraps	Rallying Banner
Barbaric Helm	Savage Raider
Barbcharged Battleplate	Sparkyspine
Barbed Cuirass	Pact of Pain
Bark Coat	Aryndel Warden
Barnacle	Hardshell Sealord
Barnacle Bangle	Kraken Guard Seapriest
Basilisk Staff	Blind Basilisk
Bastard Sword of Bokrug	Bastardspawn of Bokrug
Bastard Sword of the Larva	Killarvae
Battery Helm	Energize
Battle Jellies	Critical Jamage
Battleborn Boots	Living Totem
Battleborn Breastplate	Prince Talysen
Battlecage Battleplate	Liberated Berserker
Beagle's Footpads	Evolved Tactics
Bear Gloves	Arctic Grizzly
Bear Idol	Dream Bear
Beastcaller Vest	Wildwood Beastcaller
Beastly Foot-Stompers	Gorilla Pounder
Beckoner	Darad, the Scourgeblade
Beckoner's Boots	Awakened Herald
Beckoner's Cuirass	Royal Herald
Benjamin's Orb	Crackling Wit
Beseecher's Breastplate	Beseech the Ancients
Bewilderment Boots	Discombobulate
Bewilderment Bracers	Discombobulate
Big Bad Beetle Bag	Cadaver Beetle
Big Boulder	Boulder Behemoth
Big Red Button	Plan C
Billy Boots	Baa'tle Master
Bird Feeders	Mystic Naturalist
Black Crucible Wraps	Hand of the Black Crucible
Blackest Veil	Bride of the Damned
Blackwolf Stave of Starcaller	Starcaller Ancient
Blade Flourish Boots	Blade Flourish
Blade of Destiny	Destined to Lead
Blade of Lazarus	Myrym, Empress of the Crypt
Blade of Many Names	Heroic Inspiration
Blade of Sekki	Oni Assassin
Blade of the Eternal Feast	Brutecrown Gorger
Blade of the Sensei	Silent Blade Sensei
Blade of the Woodstalker	Wild Aura
Bladecrafter's Banisher	Expert Bladecrafter
Blademaster's Gloves	Ashwood Blademaster
Blasting Boots	Crackling Blast
Blazing Gloves	Blazemaw
Bleached Brooch	Ivory Pawn
Blight Pod	Blightvines
Blight Resin	Blightseed Fiddler
Blight Shovel	Blightseed Cultivator
Blightbark Gauntlets	Blightbark Thrall
Blighted Bangle	Blighted Seedbearer
Blighted Breastplate	Blightbark Vampire
Blightwater Paddle	Blightwater Ferryman
Blitz Boots	Blitz Boyz
Bloated Cap	Bloatcap
Blood Bauble	Furious Taskmaster
Blood Fueled Gloves	Feralfuel Infusion Device
Blood Soaked Slippers	Royal Bloodline
Blood Soaked Tiara	Royal Bloodline
Blood-Soaked Wraps	Death Chant
Bloodlust Invokers	Bloodlust
Bloodpit Axe	Bloodpit Reaver
Bloodsoaked Knuckles	Bloodsoaked Brawler
Bloodstained Crown	Prince Zakkaz
Bloodsucker Helm	Giant Mosquito
Bloodworm Boots	Leeching Burrower
Bloody Knuckles	Zanya Bloodfist
Bloody Mitts	First Blood
Bloomfall Basket	Bloombringer
Blossom of Friendship	Rose Kitten
Blue Fanged Ring	Azure Fang Hierarch
Bluebell Boots	Bluebell Dryad
Body Tank	Surge Mechanism
Bog Walkers	Highlands Magus
Bog Walkers Robes	Bog Walker
Bokrug's Veil	Splinter of Bokrug
Bold Stompers	Assault Bot
Bolt Flingers	Sword Trainer
Bomb	Mechanized Aerialist
Bone Grips	Bone Goliath
Bone Studded Bludgeon	Brutal Bonecracker
Bone Walkers	Sepulchra Bonewalker
Boned Gloves	Ankylosaurus
Book of Ossein	Mistress of Bones
Bookmark Blade	Tome of Uruunaz
Boom Shoes	Boomsmith
Boots of Autumn	Bellow of Briggadon
Boots of Bloody Tribute	Fang of the Mountain God
Boots of Ceremonious Flame	Pyre Ceremony
Boots of Equine Flight	Spearcliff Pegasus
Boots of Oblivion	Shoggoth
Boots of Puncturing	Ruby Lance
Boots of Renewal	Iddi
Boots of the Dawn	Ascetic Aspirant
Boots of the Hopeheart Martyr	Hopeheart Unicorn
Boots of the Martyr	Bucktooth Roshi
Boots of the Plague Walker	Sorrow
Boots of the Prodigen	Immolith
Boots of the Sensei	Silent Blade Sensei
Boots of the Source	Grim Mandate
Boots of the Waltz Macabre	Danse Macabre
Boots of the Zephyr	Arcane Zephyr
Borean Bracers	Borean Chimera
Borean Dagger	Borean Leopard
Bot Mind-Melder	Reese the Crustcrawler
Bottle of Vintage	Rollicking Reveler
Bottled Courage	Ardent Courage
Bottled Gas	Gas Troll
Bow of Soul's Chill	Harvester's Reaper
Bow of the Howler	Echohowl Alpha
Bow of the Surgesmith	Surgesmith Engineer
Box of Holy Bells	Night of Bells
Bracers of Brutality	Brutal Commander
Bracers of Manufacturing	Construct Guild Underboss
Bracers of the Antlerguard	Caribaur Antlerguard
Bramble Boots	Wrathwood Master Moss
Bramblebriar Helm	Briarpatch
Breached Socks	The Ruin of Ripplewood
Breast of the Phoenix	Wildflame Phoenix
Breastplate of Pride	Eldurathan's Glory
Breastplate of Pulverizing	Rampaging Tarasque
Breastplate of the Behemoth	Horrorcrafted Behemoth
Breastplate of the Blackheart	Blackheart Paladin
Breastplate of the Zealot	Gore Feast of Kog'Tepetl
Breeze Bolstered Boots	Whispering Breeze
Breeze Walkers	Invigorating Breeze
Brewmasters Boots	Brewmaster Buzzlebeard
Briarpatch Bracelet	Briarpatch Conjuror
Briggadon's Chestplate	Fist of Briggadon
Brighthammer Barbute	Brighthammer Adept
Brightmoon Boots	Brightmoon Brave
Brilliant Chestplate	Brilliant Tactician
Briny Robes	Salt Harpy
Bristled Breastplate	Bristlebarb Hag
Brittle Bone Guard	Rotting Away
Broach of the Tactician	Phoenix Guard Tactician
Brooch of Lunacy	Lunacy
Brown Leather Vest	Brown Fox Scout
Bruiser's Casing	Cottontail Bruiser
Brutal Boots	Brutal Brawler
Brutal Scimitar	Emberbrute
Brutal Standard	Jacked Brutalizer
Bubalus Bauble	Livid Buffalo
Bubble Mail	Air Elemental
Bubble Sting Bottle	Bubblebee
Buffalo Stew Bowl	Trotting Buffalo
Builder Top	Builder Bot
Bull Shark Tooth	Bull Shark
Bulldog Cudgel	Guard Dog
Bulwark of the Cinderclone	Cinderclone Offensive
Bulwark of the Impenetrable	Protectorate Defender
Bulwark of the Silver Talon	Exalted Commander
Bunny Slippers	Wakizashi Warbunny
Burning Armband	Burning Zombie
Bursting Bands	Blightbark Burster
Bursting Bauble	The Crowd Roars!
Bushwacker	Jungle Ambush
Butterfly Necklace	Kiss of the Princess
C.A.G.E. Drill	Robo Gnoll
Cackling Cranium	Scraptooth Cackler
Cafe Nether	Bitter Dread
Cake Cutter	Poppycakes
Calcified Greaves	Walking Boneyard
Call of the Flesh Eaters	Determined Zombie
Call to the Air	Earthcaller
Caller's Cowl	Transcend
Callow Clogs	Naive Lackey
Camouflage Boots	Ancestral Ambush
Camouflage Headband	Ambush Guide
Camouflage Vest	Master of Masks
Candle Lighters	Kindlekit
Candlelit Crown	Candle Crush
Cannibal Pestle	Gravebane Vial
Canvas Gloves	General's Tent
Cap of the Disgusting Insect	Grub Crawler
Capitulation Chestguard	Succumb To Madness
Captivating Guise	Enthralling Gaze
Caress of the Void	Chaotic Rip
Carnage Helm	Goreseeker
Carnal Knowledge	Succubus
Carnasaur Handlers	Carnasaurus
Carnasaurus Tooth	Carnasaurus
Carrion Mask	Carrion Thrasher
Casing of the Unseen	Shellsafe Sure Shot
Cavalry Greaves	Adamanthian Cavalry
Cavorting Chestguard	Wild Root Dancer
Celebratory Gloves	Holiday
Celestial Aegis	First of the Host
Celestial Map	Zodiac Shaman
Cement Shoes	Clutch of the Depths
Cerberus Collar	Cerberus
Ceremonial Coronet	Nibblin Ceremony
Ceremonial Guard	Mentor of Oakhenge
Ceremonial Hands	Benediction
Ceremonial Sash	Nibblin Ceremony
Cereus Headress	Life From Death
Certificate of Receipt	Contract Killing
Cerulean Charged Clog	Rite of Denial
Chain of the Marksman	Deadeye Marksman
Chain Shoes of Oblivion	Soul Cube
Chainstrike Mauler	Whirling Brutalizer
Chalice Gauntlets	Chalice of the Victor
Chaos Vine Vest	Pod of Shoggoth
Chaotic Cloak	Chaotic Murmurs
Charging Helm	Onslaught
Chest of Electrical Force	Cerebral Jack-hat
Chest of the Gatekeeper	Sophro's Gatekeeper
Chest of the Oni Order	Swiftpaw Trickster
Chestguard of Murmurs	Voice of Tombs
Chestguard of the Forager	Apex Forager
Chestguard of Zealotry	Bloodcrazed Zealot
Chestplate of Courage	Militant Paladin
Chewed up Boots	Mawstorm
Chickatwice Skin Jacket	Chickatwice
Chisel of the Necropolis	Necropolis Tablet
Chitinous Gloves	Dream Spider
Chittering Chains	Walking Hive
Chrome-etched Chestguard	Chrome Guardian
Chrono-glass Flail	Chronodaemon
Cindering Charge Treads	Army of the Arcane Cinder
City Watch Greaves	Captain of the Dragon Guard
Clashing Boots	Crackling Clash
Claw of Rampage	Runeclaw Berserker
Claw of the Phoenix	Wildflame Phoenix
Claw-toed Kickers	Scarcliff Chimera
Claw-toed Shoes	Chupacabra
Clay Claw Hammer	Experienced Masons
Cleric's Mace	Xentoth's Zealot
Cloak of Confession	Confession of Embers
Cloak of the Marrowmage	Marrowmage
Cloak of the Witching Hour	Midnight Spiritualist
Cloaking Cover	Hide and Seek
Cloud Gauntlets	Hawkwind
Cloudfeather Fan	Cloudwalk
Coat of the Tracker	Feralroot Tracker
Cocktail Shakers	Verdant Mixologist
Cog of the Machine	Adaptatron
Coil Gauntlets	Induction Coil
Coiled Walking Cane	Shillelagh Bully
Cold Chisel	Sorcerous Sculpting
Cold Weather Boots	Chained Peak Yeti
Colossus Shadow Axe	Jacked Colossus
Combat Boots	Underworld Officer
Combat Trail Blazers	Psychotic Anarchist
Comeuppance Helm	Judgement
Commander Armguards	Underfoot Commander
Commander's Brooch	Orders From High Command
Commander's Bullhorn	Field Tactician
Commonwealth Sandals	Gain Ground
Concealed Weapon	Fierce Justicar
Conductor's Wand	Ashwood Maestro
Confectioner's Boots	Treat Machine
Conflagration Gauntlets	Ruby Pyromancer
Conflagration Handguards	Burn
Conflagration Staff	Flamethought Seeker
Conservatory Candle Stick	Lumagoth
Constellation Blade	Zodiac Divination
Construct Guild Armor	Tavish, Construct Guild Boss
Construction Gloves	VB1311
Consuming Receptacle	Aura Eater
Containment Slippers	Containment Sphere
Convoy's Cap	Vilestrain Convoy
Cool Bracelets	Chill
Coriolis Boots	Cloud Titan
Corn Huskers	Stingy Jack
Corona Spear	Sunspeaker of Wakuna
Corpse Anchor	Bonetide
Corpse Caller's Catch	Corpse Caller
Corrupted Garrote	Relentless Corruption
Corvid Feather	Croven Memorythief
Cosmic Crown	Cosmicron
Cosmic Pendant	Ozawa, Cosmic Elder
Cosmic Warbonnet	Cosmic Flashpaw
Cotton Tuft Striker	Uzume's Handmaiden
Cottontail Jutte	Cottontail Ronin
Counselor's Staff	Diligent Counselor
Coupled Headgear	Double Trouble
Cover of Mysticism	Blades of Bone
Cowl of Emptiness	Slithering Marauder
Cowl of the Black Crucible	Eye of the Black Crucible
Cowl of the Nightstalker	Vampiric Nightstalker
Cradle of Madness	Dark Descent
Crafter's Cuffs	Crafty Skycarver
Crank Bazooka	Construction Plans: Crank Rocket
Creep Eye Gloves	Cavern Creeper
Crest of the Strikeforce	Strikeforce Sergeant
Crier's Handbell	Town Crier
Crimson Copperhead	Crimson Clarity
Crippling Spear	Cripple
Croven Dagger	Croven Memorythief
Crown of Blood Bonding	Wrathseeker
Crown of Indignation	Fiery Indignation
Crown of Proclamation	Vengeance of the Ancient Kings
Crown of the Ancient Kings	The Ancestors' Chosen
Crown of the Cloud King	Cloud King
Crown of the Goblin King	Bowie Starlight
Crucible Crudgle	Eye of the Black Crucible
Crucible Handlers	Tongue of the Black Crucible
Crush Boots	Death Dealer
Crustacean Cleaver	Hardshell Sealord
Crying Avatar Bust	Weeping Banshee
Crypt Runners	Mordrom's Gift
Cube of The Hatchery	Fanged Fanatic
Cuffs of the Harvestman	Arachnoglider
Cuirass of Judgement	Angel of Judgement
Culler's Blade	Merciless Culler
Cultist Coiffure	Mad Aradam Cultist
Cultivation Cap	Kaliban's Cultivation
Cultivators Caressers	Hatchery Cultivator
Cumulus Choker	Storm Cloud
Cursed Ink of Yazukan	Scroll of Yazukan
Curtail Cleats	Storm Rider
Cut of the Mountain	Rune Ear Commander
Cute Shoes	Changeling Cuties
Cutlass of Storms	Stormsprite
Cutthroat Compass	Ruthless Cutthroat
Cyborg Switch	Scraptooth Cyborg
Cyclops Spiked Shoulders	Obsidian Cyclops
Dagger Handlers	Sneakblade of the Milky Eye
Dagger of a Thousand Needles	Nibblin Swarm
Dagger of Eggblight	Eggblight Afflictor
Daisy Chain	Fever Bloom
Damned Visage	Ash Harpy
Dancing Boots	Dream Dance
Dancing Coif	Dancing Faeries
Dandelion Arm Guards	Crackling Sprout
Dangerous Threads	Woven Golem
Dark Disciple's Robes	Deepgaze Disciple
Dark Dreaming Vest	Sterling Starwatcher
Dark Slippers	Dark Echoes
Dark Tourniquet	Dark Echoes
Darkfur O-Yoroi	Darkfur Tailcutter
Darkspire Armor	Darkspire Enforcer
Darkspire Longblade	Darkspire Priestess
Daughter's Day Dress	Daughter of the Poet
Dauntless Staff	Sister Cynthia
Dawn Chargers Cowl	Dawn Charger
Dawnsteed Guiders	Dawnsteed
Day Dress	Sunrise Specter
Dead Man's Mark	Claws of the Dead
Deadeye Long Lacers	Deadeye Enforcer
Deathly Cowl	Elegy of Death
Decayed Robes	Decaying Dead
Decaying Hand	Decaying Giant
Declivous Cap	Dark Descent
Defiler's Necklace	Defiler of the Fallen
Deft Fletchers	Silent Shot Skirmisher
Deft Leather	Silent Shot Skirmisher
Degenerative Mace	Atrophy
Delivery Gloves	Wretched Wrangler
Depth Calibration Unit	Quicksand
Depth Gage	Old Man of the Sea
Deranged Chapeau	Dementia Daisies
Desired Pendant	Dark Desire of Nulzann
Dew Gatherers	Sparklecap
Ding Dong Ditchers	Tricky Tykes
Dingler Twig	Mass Polymorph: Dingler
Dinglewand	Dinglewiz
Dino Boots	Mecha T-Hex
Dino Club	Ankylosaurus
Dinoskin Duds	Dino Might
Dire Web Wraps	Dire Spider
Diseased Bone	Plague and Famine
Disembodied Head Resonator	
Displacement Collar	Vile Squirmhound
Disruptive Drivers	Disruptor Drone
Distasteful Boots	Taste of Defeat
Diving Tunic	Scallath
Divinity's Hymn	Angel of Dawn
Dogweed Duster	Poppy Pup
Dome of Extraction	Gront the Infinite
Doomseeker Boots	Argus, Herald of Doom
Doppel Gloves	Frenetic Doppelganger
Double Bow	Volley of Arrows
Double Brood Blade	Brood Count
Double Maw Scarf	Maw of the Hunt
Double-Bladed Sword	Darkspire Acolyte
Double-Step Boots	Moment of Glory
Doubling Crystall Ball	Paw of Yazukan
Dragon Crest Treads	War Prodigy
Dragonscale Gauntlets	Feral Domination
Dragonspeaker's Brooch	Dragonspeaker Daliah
Draw Bridge	Portcullion
Draxard's Heart Protector	Heartsworn Draxard
Dread Fingered Grasp	Dread Wight
Dreaded Skull Helm	Dread Wight
Dreadling Casket	Skittering Dark
Dream Cap	Dream Skarn
Dream Galoshes	Dream Spider
Dream Snatchers	Eldritch Dreamthief
Dream Staff	Enter the Dream
Dreamcatcher Headdress	Arcane Dreamcatcher
Dreamcatcher's Staff	Prophet of the Sun
Dreamstate Hood	Enter the Dream
Dreamthread Mittens	Whimsy Witch
Drifter's Lament	Eternal Drifter
Droo's Puncher	Droo's Unrelenting Fists
Dual-Bound Boots	Paired Power
Duelist's Tabard	Jags the Blademaster
Dusk Cowl	Dusk Scout
Duskwing Shard Ring	Duskwing Shepherd
Duskwing Taming Whip	Untamed Duskwing
Dusky Dancers	Dance of Dusk
Dusty Duster	Dust Cloud
Dusty Tail	Dust Bustard
Dwarven Fishing Pole	Dwarven Fish Bait
Eagle Feather Staff	Cry of the Eagle
Eagle Feathered Gloves	Dream Eagle
Earthcaller's Robes	Earthcaller
Efficient Waste Remover	Mechanized Compactor
Eggblight Bracers	Eggblight Stalker
Eggsackers	Spider Nest
Elastic Waistband	Egg Hunt
Electric Flail	Lightning Elemental
Elemental Gloves	Storm of the Century
Elite Handwraps	Rune Ear Elite
Ember Flurry Battle Axe	Shatter Shield
Ember Walkers	Rain of Meteors
Emberguard Robe	Elite Pyromancer
Emberleaf Sabre	Emberleaf Wardancer
Emberstrike Helm	Gallant Duelist
Embezzled Boots	Awaken
Emblazoned Chestguard	Gareth Kay
Emblazoned Gauntlet	Gareth Kay
Emblem of Adamanth	Citadel of Adamanth
Emunization Gloves	Emulate
Enchanted Walnut	Twintail Squirrel Titan
Enchanter's Footwraps	Prospero, Sylvan Enchanter
End Gauntlets	Spiraling End
End Greaves	Spiraling End
End Writer	Unwritten End
Engine Charged Shoes	Infinity Engine
Engineer's Smock	Construct Foreman
Enhanced Boots	Scraptooth Cyborg
Enhanced Fuel Ejector	Torchwing Ace
Enola Grips	Amphibious Arachnid
Ersatz Gloves	Copycat
Escalator's Wand	Zip Zapper
Escape Claws	Escape Goat
Essence of Gargalith	Gargalith
Eternal Compass	Eternal Architect
Eternal Enchanted Cowl	Twin Eternities
Eternity Sandals	Eternal Youth
Ethereal Coated Boots	Ethereal Healer
Ethereal Headwrap	Ethereal Caller
Evangelist Robes	Webspeaker Evangelist
Evening Attire	Lord Bernard P. Dunthorpe
Eventide Boots	Eventide Ender
Exoskeleton Prototype	Construction Plans: Hornet Bot
Explorer's Gloves	Cottontail Explorer
Explosive Handlers	Sapper's Wallbuster
Exsanguination Choker	Vampiric Nightstalker
Extra Firepower	LZ-37 Targeting System
Eye of the Underworld	Bloodeye Defiler
Eyes of Genius	Construction Plans: Ingenuity Engine
Eyes of Infinite Outcomes	Parallel Realities
F.L.F. Safety Helmet	Fungus Liberation Front
Face Scraper	Facetaker
Factoring Fingers	Cerebral Jack-hat
Fae Slippers	Dandelion Faerie
Faith's Shield	Bulwark of Faith
Faithful Gauntlets	Bulwark of Faith
Falconer's Tactical Gloves	To the Skies!
Familiar's Tasty Treat	Cerulean Grand Invoker
Fang of Scallath	Scallath
Fanged Barrier	Fanged Fanatic
Farsight Reachers	Lanupaw, Prophet of Fate
Fatestitched Mitts	Woven Golem
Favored Amulet	Diamond's Favor
Favored Boots	Ruby's Favor
Favored Chestplate	Wild's Favor
Favored Gloves	Sapphire's Favor
Favored Slicer	Blood's Favor
Fearful Scythe	Fearless Fray
Feed Handler's Gloves	Savage Lord
Feet of the Flashpaw	Cosmic Flashpaw
Feral Dagger	Mystic Squirrel
Feralfuel Backpack	Fuelmaster
Feralfuel Bomb	Fueling Station
Feralfuel Hyperborean Moccasin	Feralfuel Infusion Device
Feralfuel Pumps	Feralfuel Guzzler
Feralmaul	Wild Growth
Feralroot Bracers	Feralroot Tracker
Feralroot Slippers	Wild Root Dancer
Feralroot Vest	Feralroot Archdruid
Fertility Charm	Blossoming Concubunny
Festival Dress	Festival Barker
Festival Pumps	Festival Barker
Fetching Staff	Wakuna Lookout
Fidget Widget	Restless Fabricator
Fiery Judicator's Robes	Pyresoul Magistrate
Filched Charm	Imp Hoodlums
Filthy Boots	Cleanse
Finger Bone	Reprocessor
Fingerless Gloves	Artisanal Cheesesmythe
Fingers of Agony	Pained Existence
Fingers of Patience	Mystic of the Tranquil Dream
Fire Javelin	Total Meltdown
Fire-Touched Claws	Ricochet Blast
Firebolt Crossbow	Construction Plans: Ingenuity Engine
Firesale Pushers	VB213
Fireteller Helm	Incantation of Fury
Firewhip of the Setless Sun	Royal Valkyr
Flak Missile	Flak Scrapper
Flame Cut Cuirass	Vanguard of Gawaine
Flame Juggler Gloves	Playing With Fire
Flamethrower	Fuel for the Fire
Flaming Thurible	Candlelit Zealot
Flare Mantle	Matriarch of Flames
Flaring Kabuto	Cottontail Scout
Flash Frozen Fists	Dead of Winter
Flashpaw Pendant	Flashpaw Elder
Fleet Feet	Quick Strider
Fleetfoot Gloves	Canyon Fleetfoot
Flickering Knife	Flickering Gobbler
Floral Headband	Spring Dancer
Fluffy Bluff Vest	Ambling Bluff
Flush Red Cutlass	Royal Cutblood
Foil	Hired Horn Captain
Footwraps of the Stormcaller	Stormcall
Forbidden Mask	Forbidden Tomeseeker
Forboading Boots	Dread Demise
Forest Stalkers	Feralroot Jaguar
Foreststalker Gloves	Sly Huntress
Forever Blade	Forever's Child
Forged Fingers	Forge Flock
Formidable Helm	Iddi
Fossilized Horn	Tricerobot
Foxy Shoes	Fennec Fox
Fragment of Memory	Forgotten Monarch
Freak Fetters	Freak of Nature
Fresh Eggs	Egg Hunt
Fresh Fire Stoker	Purging Flames
Fresh Froggy Frock	Orchi-Kero
Fresh Spring Bloom	Spring Renewal
Frigid Deathplate	Coldheart Reaver
Frosted Fur Boots	Frosttusk
Frostmare Helm	Frostmare
Frostrune Twinblades	Coldheart Reaver
Frozen Buffalo Horn	Frigid Buffalo
Fruit Pluckers	Symeon's Bounty
Fruit Punchers	The Berry Bunch
Full Throttlers	Mortartrike Driver
Fungal Bloom	Death Cap
Fungi Fort	Noxious Banecap
Fungus Host Boots	Fungus Amongus
Furious Footguards	Furyseeker
Furious Loafers	Fury Chant
Fury Blade Balaklava	Furybringer
Fury Blade Vestments	Furybringer
Furybiter Bridle	Crazed Squirrel Titan
Gale Force Armor	Gale Force
Gallon of Chaos Milk	Whisker of Azathoth
Galvanic Gauntlets	Bottled Lightning
Gamma Gauntlets	Lumbering Gammadon
Gardener's Hat	Chlorophyllia
Gardening Gloves	Root Wrangler
Gardening Shirt	Forever's Bloom
Gauntlets of Austerity	Ascetic Aspirant
Gauntlets of Courage	Lord Alexander, the Courageous
Gauntlets of Dusk	Demon of Dusk
Gauntlets of Spite	Taste of Defeat
Gauntlets of the Tireless Watch	Protectorate Defender
Gauntlets of Vitality	Radiant Salvation
Gawaine Runners	Crusader of Gawaine
Gelatinous Footwear	Giant Jellyfish
Gelatinous Overcoat	Giant Jellyfish
Gem of Assimilation	Grim Assimilation
Gem Pocket Jerkin	Lumbering Sparklespore
Gem Scaled Gloves	Saarthu
Gem Walkers	Gemsoul Feeder
Gemblaze Greaves	Cinder Walker
General's Badge	General's Tent
Ghost Band	Spirit Dance
Ghost Hands	Ghost Howler
Ghostly Fingers	Ghost Sentinel
Ghostly Galoshes	Soul of Raqqar
Ghostly Waders	Elusive Specter
Ghostly Wrap	Lady Devonshire
Giant's Visage	Horrorcrafted Behemoth
Gift Receipt	Pippit's Gift
Giggling Guard	Giggling Scavenger
Gladiator Helm	Arena Regular
Gladiator's Dazzlers	Splitskull Gladiator
Glass Flail	Junk Barrier
Gleeful Girded Grand Guard	Jubilant Jouster
Glimmerfly Slippers	Glimmerfly Dance
Glittering Knuckles	Gem-Crazed Berserker
Glorified Gloves	Angel of Glory
Glorious Standard	Candlelit Cavalry
Gloves of Applause	Bellow of the Arena
Gloves of Betrayal	Herofall
Gloves of Conquest	Conquest of Romor
Gloves of Dismissal	Ushul
Gloves of the Airfarer	Typhoon Galleon
Gloves of the Archmage	Archmage Wrenlocke
Gloves of the Bright Moon	Brightmoon Totem
Gloves of the Dark Side	Terrible Transfer
Gloves of the Full Tankard	Portsmeare Guard
Gloves of the Manti	Druidic Exoshaper
Gloves of the Rotting Touch	Rot Caster
Gloves of the Suttee	Suffering Pyre
Gloves of the Wounded Petal	Guru of the Wounded Petal
Gloves of the Wraith	Horrific Poltergeist
Gloves of Trickery	Smirking Trickster
Gloves of Unrelenting Pain	Giant Corpse Fly
Gnatmare Anklebiters	Gnatmares
Gnawed on Armband	Mawstorm
Gnoll Gear Iron	Scraptooth Mangler
Gnome Satchel	Gnome Wayfarer
Gobbler Girdle	Engorged Gobbler
Gobbler's Footgear	Bogberg, the Great Gobbler
Gobbler's Goggles	Bogberg, the Great Gobbler
Goblin Kickers	Gront's Gift
Golden Curiass	Hardshell Guardclaw
Goldfingered Gloves	Chest'O Hex
Goliath's Gear	Inferno Goliath
Gooey Greaves	Gooplasm
Gore Thirster	Fury of the Mountain God
Gorecaster Gauntlets	Qutzul Gorecaster
Gortezuma's Ritual Robe	Gortezuma, High Cleric
Graced Guards	Angel of Agony
Graftable Augmentation Cannon	Armitron
Grafted Stave	Symeon's Bounty
Grandaddy's Compass	Royal Cutblood
Granite Cuirass	Granite Giant
Granite Gauntlets	Palm of Granite
Granite Helmet	Boulder Behemoth
Grappling Hook	Narrow Escape
Grave Blade	Graveblade Skirmisher
Grave Officer's Garment	Grave Offering
Graverazor	Gravestalker
Gravitross Slayer	Swooping Gravitross
Greatblade of Judgment	Arbiter of Twilight
Greaves of Undeath	Sudden Awakening
Greedy Gloves	War Spoils
Green Dahlia	Poppycake Peddler
Grim Armor	Grim Skull Sorcerer
Grim Elegance	Grim Mandate
Grim Wrapped Gauntlets	Grim Martyr
Grimplekin Goggles	Green Grimplekin
Grips of Lethality	Corpulith
Grips of Rapid Growth	Scion of Oberon
Grips of the Seedhearts	Tranquil Seedheart
Grips of the Warden	Battlement Spearman
Ground Pounder	Smash to the Ground
Grounding Boots	Glendower
Groundskeeper Gloves	Memory of the Fallen
Groupie's Wig	Final Performance
Grungy Ballet Slippers	Dingledance
Guardian Greaves	Slaughtergear's Guardians
Guardian's Aegis	Deathless Guardian
Guardians of the Galaxtar	Squirming Galaxtar
Guardsman's Grips	Phoenix Guard Harrier
Guiding Headcover	Warparty Guide
Guise of the Caster	Boltspasm
Hag Transport	Blightwater Hag
Halo of Glory	Angel of Glory
Hammer of the Witching Hour	Midnight Paladin
Hand of Denial	Deny
Hand of Lixil	Sir Draxard
Hand of the Thief	Circle of Ruination
Hand-Me-Down Gloves	Born to Die
Handbook of the Fatally Found	Bride of the Damned
Handpicked Handwraps	Rune Ear Recruiter
Hands from Hereafter	Hereafter
Hands of Justice	Bring To Justice
Hands of the Noble Heart	Noble Heart
Hands of the Sovereign	Vaarician
Hands of Wrath	Pool of Wrath
Handwraps of King Kagraza	Spirit of Kazraga
Hard Hatched Gloves	Hatchery Malvoker
Hare Trimmed Helmet	Probewarped Hare
Harmonious Cowl	Guiding Light
Harrier Twist Dagger	Phoenix Guard Harrier
Harvest Medallion	Harvester's Reaper
Harvesting Hands	Grim Harvester
Hastur's Tears	Harbinger of Hastur
Hasty Hard Hat	Gem Snatchers
Hasty Summoners	Grim Summons
Hat of the Witching Hour	Midnight Fever
Haunted Hauberk	Etherealize
Hawking Gloves	Phoenix Guard Messenger
Headband of Inquisition	Xentoth's Inquisitor
Headband of the Seekers	Sacred Seekers
Headband of the Troubadour	Ageless Troubadour
Headdress of Obstinance	Defiant Totemist
Headdress of the First Ritual	First Rites
Headdress of the Wind Foretold	Whispering Breeze
Headpiece of the Ardent	For the Ardent!
Healthy Heart Blade	Sora
Heartbeat Bow	Pucid's Whispers
Heartseeking Dagger	Lixil's Heartseeker
Heartsworn Collar	Heartsworn Caller
Heartsworn Throat Clutchers	Heartsworn Cutthroat
Heat Shield Goggles	Scraptech Brawler
Heathen's Idol	Oakhenge Ceremony
Heavy Bot Hammer	Heavy Welding Bot
Hedgesaurus Helm	Hedgeasaur
Heedless Headdress	Reckless Evoker
Hell Horror Helmet	Romor's Reckoning
Hellshot Vest	Hellshot Catapult
Helm of a Good Game	Entrath Settlers
Helm of Avarice	Chest'O Hex
Helm of Buoyancy	Clutch of the Depths
Helm of Capitulation	Succumb To Madness
Helm of Khloud	Mancubus
Helm of Life	Pact of Life
Helm of Many Faces	Living Totem
Helm of Revelation	Legionnaire of Adamanth
Helm of Reversion	Tinkertron
Helm of the Abbess	Sister Cynthia
Helm of the Automaton	Mega-Bot 9000
Helm of the Bombwright	Bombwright
Helm of the Dream Bear	Orson's Dream
Helm of the Elemental	Stormsprite
Helm of the Fanged Brood	Incubation Slave
Helm of the Highlands	Highlands Magus
Helm of the Moment	Lost In Time
Helm of the Monarchy	Queensguard
Helm of the Sanctuary	Zorath's Rectory
Helm of the Sun	Sun Seer
Helm of the Wild Cleric	Wild Child
Heretic Stompers	Acolyte of Xentoth
Heroes Armor	Heroic Echo
Hideous Hood	Conquest of Romor
High Counselor's Wand	Cerulean High Counselor
High Seas Raincoat	Hired Horn Captain
High-Rise Cloudbuster	Construction Plans: Tower Hulk
Highguard Hands	Cerulean Highguard
Highguard Helm	Cerulean Highguard
Hill Stompers	Subterranean Spy
Hired Horn Boots	Hired Horn Cutthroat
History of Entrath: Vol I	Skyspire Scholar
Hoarfrost Bracers	Hoarfrost Magus
Holy Beads	Protectorate Clergyman
Holy Hilted Blade	Uzume's Handmaiden
Hood of Insight	Tome of Knowledge
Hood of Leeching	Death Cap
Hood of Momentous Opportunity	Exalted Pathfinder
Hood of the Darkspire	Darkspire Tyrant
Hood of the Dragon Cultist	Zeedu
Hood of the Holiday Feast	Holiday
Hood of the Milky Eye	Milky Eye Venom
Hooded Walker	Ghost Walker
Hookah of Enlightenment	Professor Sporzin
Hoop of the Kraken	The Kraken
Hope Reborn	Hope on the Horizon
Horn of the Wool'vir	Wool'vir Baa'serker
Horned Helm	Radiant Salvation
Horticulturist's Machete	Hedgeasaur
Howling Headband	Wildwood Beastcaller
Hulk Helm	Construction Plans: War Hulk
Humble King's Crown	Pride's Fall
Hungering Battle Axe	Hunger of the Mountain God
Huntsman's Grips	Windsinger, Master of the Hunt
Hurricane Hands	Tempestuous Bladedancer
Hushed Cutter	Spectral Assassin
Icarian Slippers	Wings of Wax
Ice-Wrapped Arms	Hogarth the Mad
Icy Aviator's Cap	Woolly Moa
Idol of Kazraga	Spirit of Kazraga
Idol of the Concubunny	Uzume, Grand Concubunny
Illuminated Disc	Coins of Kismet
Illuminated Sheet Music	Choir of Lumos
Imagination Drafter	Ingenious Engineer
Imp Tools	Demolitionist Hijackers
Imperial Grips	Emperor Ito's Will
Imperial Headpiece	Emperor's Lackey
Improvised Helmet	Battle Chant
Incredibly Attractive Hair Piece	Master of Masks
Incubation Mace	Incubate
Infectious Toxin	Casualty of War
Inferno Bracer	Inferno Goliath
Infiltration Slippers	Runeweb Infiltrator
Infiltrator's Hood	Ridge Raider
Infinite Energy Conduit	Infinity Engine
Infinitely High Boots	High Infinitrix
Ink-Stained Gloves	Adamanthian Scrivener
Ink-Stained Vestments	Battle Scrivener
Insignia of the Marmot	Mystic Squirrel
Insulated Cover	Scutt's Sparker
Ironroot Gloves	Glimmerglen Witch
Ironsilk Stitches	Arachnomicon
Jackhat Controller	Jackhat Heckler
Jailor Boots	Fungal Monstrosity
Javelin of the Ayotochi	Ayotochi Brute
Jeering Jaw	Twisted Taunter
Jewel of the Exarch	Exarch of the Egg
Jinglejinx Gloves	Jinglejinx Witch
Judgment Day	Zeddek's Judgment
Juggernaut Ring	Rampaging Tarasque
Jungle Trekkers	Jungle Ambush
Junk Crown	Bombsmith
Jurassic Sandals	Savage Lord
Jurassic Vine Whip	Chlorosaur
Justicar's Jacket	Grim Justice
Kensei's Curved Blade	Soulblade Samurai
Kindling Gauntlets	Kindling Skarn
King Ook Bok's Crown	Battle of Destiny
Kingmaker Gloves	Crushing Blow
Kit Catchers	Fertile Engorger
Kog'Tepetl's Breastplate of Savage Regeneration	Claw of the Mountain God
Korru Galoshes	Korru Infiltrator
Kukatan Coin	Halls of Kukatan
Kunai	Blade Juggler
Lady Violet's Crown	Lady Violet Blightbark
Lamprax Beads	Lamprax Lurker
Lance Guard	Risen Lancer
Lantern of the Cloud Queen	Cloud Queen
Larch Leash	Wrathwood Larch
Large Cranium	
Large Monocle	Oculus of Azathoth
Lazgar Split Helm	Lazgar Chul
Leather Dueler's Duds	Ghostblade Duelist
Librarian's Shoes	Researcher Adept
Library pass	Book Smarts
Lifebinder Boots	Mylaanth the Lifebinder
Lifetaker Hood	Blood Aura
Lightning Infused Claw	Robotic Rapture
Lightning Medallion	Arena Brawler
Lightning Staff	Thunderfield Enchanter
Lightplate	Scouring Light
Lion's Head	Scarcliff Chimera
Little Nimomancer Sceptor	Nimomancer
Live Wire Handlers	Scrapyard Dynamo
Lixil's Ageless Brooch	Lixil, Heartsworn
Lixil's Sticker	Eye of Lixil
Llama-Skin Cloak	Llama Herder
Locket of Creation	Pupil of Creation
Locket of Lost Memories	Wailing Banshee
Locketech Jackhat	Zoltog of the Pack
Lodegan's Ring	King Lodegan's Verdict
Lone Ring	Ardent Fellowship
Lonely Axe	Solitary Exile
Long Wick	Scion of Lyvaanth
Lord Adam's Ballista	Citadel of Adamanth
Love Triangle	Lovebound
Lovebound Barbut	Lovebound
Loveinomicon	Pucid the Matchmaker
Low Gravity Claymore	Charge Hulk
Lowlife Wraps	Eager Lackey
Luminous Raiment	Devoted Luminist
Luminous Skylance	Lyvaanth's Skylancers
Lunatic Kickers	Maniacal Entrepreneur
Lyricist Quill	Lithe Lyricist
M.A.P. Maker's Pick	M.A.P.S. Bot
Maceration Makers	The Berry Bunch
Machination Sabatons	Malevolent Machinations
Maggot Marauders	Starving Lich
Magma Boots	Crackling Magma
Magma Waders	Molten Tides
Mallet of Miracles	Bulky Bisporus
Mandibles Mace	Giant Centipede
Mane of the Chimeerkat	Chimeerkat
Mangler's Tooth	Scraptooth Mangler
Manic Robes	Howling Madness
Mantle of Silent Purpose	Eternal Drifter
Manual of Martial Techniques	Moon'ariu Sensei
Marble Cutting Handguards	Soul Marble
Mark of Destruction	Rust and Ruin
Marked Card	Pippit Hustler
Marmaladers	Critical Jamage
Marshpit Club	Marshpits Troll
Mask of the Healer	Cleansing Touch
Mask of the Steel Assassin	Kill
Mask of the Windbourne	Windbourne Disciple
Masonry Gloves	Experienced Masons
Matching Locket	Locket of Reflection
Matchmaker's Mitts	Pucid the Matchmaker
Matron's Jeweled Amulet	Gemborn Matron
Matron's Vestment	Gemborn Matron
Maw of the Void	Pod of Shoggoth
Meat Carver	Callous Carver
Mechanical Sarcophagus	Reaper Bot
Medal of Falconry	Royal Falconer
Medal of the Master Gambit	Ebony Pawn
Medallion of Gliding	Duskwing Maiden
Medallion of the Arena	Moqui
Medallion of the Scraptooth	Scraptooth Bouncer
Medical Mace	Field Medic
Meditation Stompers	Iljuni Mediator
Melodists Bracers	Feralroot Songstress
Mentor's Slippers	Nori
Mercenary Gloves	Hired Horn Sellsword
Mercurial Boots	Alchemy Lab
Merry Mitts	Merry Mascot
Merryman Vestments	Friar Tusk
Metal, Mind Case	Psionic Barrage
Metasoma of Mutation	Nox Zealot
Meteorite Gauntlets	Dragon Guard Stalwart
Meteorite Grips	Rain of Meteors
Midnight Soiree Gown	Gobbleglade Witch
Midsummer Cloak	Puck, Dream Bringer
Mighty Hands	Might Makes Right
Mighty Morphing Glove	Morphology
Militia Marchers	Shin'hare Militia
Mim's Staff	Angel of Foresight
Mimicking Moccasins	Mimic
Mind Rakers	Mind Rake
Minstrel Baton	Ashwood Minstrel
Minstrel Gloves	Merry Minstrels
Mirthkin Loupe	Iljuni Mirthkin
Missionary Robes	Xentoth's Missionary
Mist Shroud	Phantasmal Slayer
Modular Breastplate	Lady Cassandra
Mollifying Mitts	Soothing Seedstag
Molten Corona	Cremate
Molten Mittens	Molten Tides
Monarch Vest	Kiss of the Princess
Monster Costume	Tricky Tykes
Moon Boots	Blizzard
Moon'ariu Saya	Battle Hardened Pa
Moqui's Bloodletter	Moqui
Mordrom's Heart Scepter	Heartsworn Mordrom
Morphing Footwraps	Polymorph: Dingler
Mossling Dandelion	Wrathwood Master Moss
Most Precious Thing	War Spoils
Mountain God's Vest	Hunger of the Mountain God
Mucus-Coated Mail	Scourgecrag Witch
Mud-caked Boots	Tilling the Soil
Mukluk of Starlight	Starlight Shaman
Mushroom Cap	Freaky Fungus
Musky Leather Gloves	Dream Stag
Mutt Whistle	Houndmaster of Ardevaas
Mystic Pipe	Dreamsmoke Mystic
Mystical Shawl	Arcane Dreamcatcher
Mythical Crown	Army of Myth
Name Claimer	Nameless Peddler
Nameless City Stilettos	Nameless Citizen
Nameless Kris	Nameless Truths
Nameless Mitts	Nameless Mists
Nature's Protection	Moldmass
Naughty and Nice	Yule Tide
Nebuloid	Coiling Nebulax
Necrohelm	Necrophet
Nefarious Helm	Nefarious Corruptor
Netcasting Merit Badge	Brood Net
Nibblin Knick Knack	Nibblin Skirmisher
Night Tearer	Nyctophobia
Night Wraps	Night of Bells
Nightbloom Trodders	Nightbloom
Nightsky Handlers	Nightsky Stargazer
Nimble Boots	Reginald Lancashire
Nimble Nimbus Boots	Cloud Runner
Ninja Shroud	Ninja Training
Nomad's Vest	Lost Wanderer
North Wind Chimes	Air Elemental
Nulzann Chest	Fiend of Nulzann
Nulzann's Malicious Injector	Sentry of Nulzann
Nulzann's Upgrade Boots	Scion of Nulzann
Nursery Handlers	Hatchery Priest
Oddly Shaped Sphere	Containment Sphere
Officer's Axe	Ardent Officer
Okka Chokka Okka Chokka	Drokka Outcast
Old Man's Chest	Old Man of the Sea
Old Reliable	Wounded War Hero
Omniloafers	
One Hundred Teeth	Piranha Swarm
Oni Headscarf	Swiftpaw Trickster
Orator's Doctrine	Nameless Orator
Orb of Harmony	Genesis Pool Naiad
Orchin Lenses	Orchi-Notion
Organ Trail Blazer	Blight Wagon
Otherworldly Claws	Claws of the Dead
Outrider's Clutch	Chimera Guard Outrider
Overkill Mace	Emperor Ito's Will
Owlmaster's Glove	Wizard of the Silver Talon
Ozawa's Bite	Ozawa, Cosmic Elder
Pactmaker's Bespoke Boots	Pactmaker Heretic
Pads of the Pious	Devoted Emissary
Page Flippers	Engrossed Bibliophile
Pal's Pajamas	Pippit Pal
Pale Harvest Healer	Pale Harvester
Pandemonium Perforators	The Ruin of Ripplewood
Pappy Jasper's Whip	Pappy Jasper
Party Hat	Merry Caravan
Patch of the Rover	Heroic Outlaw
Patience	Princess Victoria
Patrician's Armor	Noble Outrider
Patrician's Sword	Noble Outrider
Pearled Dagger	Hopeheart Unicorn
Pegasus Feather	Spearcliff Cavalier
Pendant of the Black Knife	Fiendish Cabalist
Pendant of the Eternal Soul	Guardian Angel
Pendant of the Grave Crawler	Minion of Yazukan
Pendant of the Triumvirate	Royal Herald
Perfect Strike Pendant	Mazat Ranger
Performer's Garb	Sylvan Duet
Peripheral Enhancers	Blindside
Phantasmal Armor	Spectral Acorn
Phantasmal Grips	Spectral Acorn
Phoenix Feather	Protectorate Sorcerer
Phoenix Guard Buttress	Phoenix Guard Tactician
Pick of Power	Transcend
Pint of Merry Ale	Alluring Alemaid
Pious Plate Gauntlets	Devout Crusader
Plague Burst Armor	Plagueheart
Plain Metal Helm	Glyph-covered Wall
Plans for Destruction	Tectonic Megahulk
Plasm Handlers	Gooplasm
Pocket Protector	Pocket Army
Poison-Tipped Blade	Noxious Banecap
Politician's Garb	Orders From High Command
Polymorphed Pelt	Belligerent Badger
Poor Yorick	Stirring Oration
Poppy Pouncers	Poppy Pixie
Porcini Paws	Shroom Party
Portable Alchemy Kit	Alchemy Lab
Portable Hole	Weave into Nothing
Porter Gauntlets	Blood Bearer
Potion of Swiftness	Oni Assassin
Powerforge Gauntlets	Samson, Lead Ballistics Engineer
Prairie Leather	Snarling Brave
Prairie Runners	Howling Brave
Precision Bow	Volley
Predatory Boots	Predatory Prey
Prefabrication Boots	Construct Guild Underboss
Prickly Ammo	Hellshot Catapult
Primitive Boots	Jurassic Spark
Primordial Bustier	Primordial Caves
Princess Boots	Princess Cory
Princess Gloves	Princess Cory
Proclamation Guardian	Underworld Decree
Proclamation Treads	Ardent Decree
Prodigen Gauntlet	Serrilith
Prodigen Helmet	Stratolith
Prodigy Gloves	Prodigy of Volosolov
Production Chestguard	Mass Produce
Production Template	Mass Produce
Professor's Sash	Professor Sporzin
Propagation Helm	VB1311
Prophecy Cover	Tale of Destiny
Prophetical Pipe	Prophet of the Sun
Proselytizing Sabotons	Xentoth's Missionary
Provoker's Helm	Ambershire Instigator
Prowling Slippers	Shadowblade Lurker
Psilocybin Slippers	Shroom Party
Puck's Piccolo	Final Performance
Puffball Ballista	Potent Puffball
Pulsating Blood Mind	The Killipede
Pulse Keeper	Impulse
Pureheart Armor	Dispel
Purgatory Palms	Life From Death
Purity Mark	Purify
Purple Pointed Purgers	Purging Flames
Purrrty Robes	Copycat
Purveyor's Grips	VB213
Pyre Stompers	Destructive Marauder
Pyre Weld Warhammer	Pyre Strike
Pyreblade Pendant	Pyreblade Slicer
Pyresmoke Tunic	Pyresmoke Cabalist
Pyretic Vestments	Pyre Ceremony
Pyroknight Chainmail	Pyroknight
Quazarion Boots	Greater Quazarus
Quick Flame Boots	Psionic Flame
Quicklitter Cottoncatcher	Snare Trapper
Quinary Gems	Exalted Professor
Qutzul-rider Leather	Qutzul Gorecaster
R.O.I.D.S.	R.O.I.D. Bot
Radiant Plate	Radiant Physician
Ragged Mourning Gown	Mentor of the Grave
Rainshaker Staff	Mentor of the Song
Rancid Mace	Paladin of Naagaan
Rancor Wedge	Rotten Rancor
Ranger's Loop	Sly Lookout
Ranger's Mitts	Valiant Escort
Raptor Boots	Pack Raptor
Raven's More	Mindsnatch Raven
Raver's Cleaver	Raving Ghoul
Razor Grips	High Tomb Lord
Razor Thorn Whip	Plant Garden
Razorboard Battle Axe	Razorboard Shredder
Reactive Power Core	Blaze of Glory
Reading Glasses	Book Smarts
Reaper's Footwraps	Unmerciful Tormentor
Reaper's Helm	Corrupt Harvester
Reaper's Scythe	Reaper Bot
Reaver Ringmail	Slaughtergear's Reaver
Reboot Gloves	Augmentation Bot
Reckless Robes	Reckless Evoker
Recruiter's Ring	Underworld Recruiter
Recycling Center	Scrapyard Recyclatron
Redefineable Adaptable Cuirass Device	S.P.A.M. Bot
Redfur Cap	Redfur Ranger
Redounding Odachi	Bucktooth Bannerbunny
Redshog's Brutal Helm	Feral Ogre
Reflective Gloves	Mirror, Mirror
Rendezvous Slippers	Pucid's Whispers
Rending Hammer	The Crowd Roars!
Replica Charm	Replica Reinforcements
Replica Rocket	Rustbucket Distractor
Replicator Helm	Slaughtergear's Replicator
Reptilian Faceplate	Kindling Skarn
Repurposed Robes	Awaken
Resplendent Chestguard	Radiant Armor
Resurgence Gown	Benediction of Lumos
Reverie Chestplate	Orson's Dream
Revised Priming Helm	Electroid
Riddle Facemask	Chrome Guardian
Rider's Glorious Chest	Glorious Pegasus
Rider's Glorious Headpiece	Glorious Pegasus
Rift-Stitched Gloves	Rift Spasm
Riftstorm Coat	Riftstorm
Rigid Bracer	Rigid Buffalo
Rime Walkers	Zephyn
Ring of Goodfellow	Puck, Dream Bringer
Ring of the Queensguard	Lady Cassandra
Ring of the White Tower	Shield Trainer
Ripped Garments	Smash Magus
Ripper Vest	Deadeye Ripper
Ritch-Ratchet Wrench	Frothfang Cackler
Ritual Robe of Xentoth	Xartaxis, Bishop of the Azure Fang
Robber's Gloves	Entrath Settlers
Robe of Ill Fate	Kismet's Reverie
Robes of Dark Rebirth	Corrupt Harvester
Robes of Infiltration	Highlands Shinobi
Robes of Interest	Engrossed Bibliophile
Robes of Sublime Sacrifice	Shin'hare Eulogist
Robes of the Mystic	Venerable Mystic
Robes of Yazukan	Disciple of Yazukan
Robo Readers	Tireless Researcher
Robo-Fused Armor	Tech-tician
Robo-Oil	Robogoyle
Robotic Multi-Tool	Recovery Specialist
Rock of the Scorpion King	Emperor Nox
Rock Throwing Gloves	Baby Yeti
Rock-Rider Gloves	Motor-Chariot
Rookie Boots	Deployment Orders
Rootforged Tunic	Rootforged Regalia
Rose Circlet	Ruby Aura
Rose Emblazoned Tabard	Herald of Roses
Rose of Continuity	Reversion
Rose Wilted Dress	Baroness Floriana
Roshi Cloak	Bucktooth Roshi
Rot Soup	Rot Cast
Rotting Boots	Crackling Rot
Rotwood Sandals	Rotroot Enchanter
Rowdy Rod	Rowdy Ringmaster
Royal Crib	Royal Stork
Royal Cuirass	King Lodegan's Verdict
Royal Halberd	Royal Halberdier
Royal Helm	King Lodegan's Call
Ruin Rod of Romor	Romor's Reckoning
Rumbling Buffers	Ready to Rumble
Rune Carved Seed	Runic Growth
Rune Carved Wand	Runic Missile
Rune Etched Blade	Runic Fury
Rune Repousse Helm	Runic Upheaval
Rune String Harp	Satyr's Song
Runebound Boots	Runebind
Runecarved Pickaxe	Runeseeker
Runecraft Gloves	Master Runecrafter
Runeflect Boots	Runeflection
Runestitched Leggings	Runeclaw Berserker
Runeweb Armguards	Runeweb Weaver
Runic Armor	Rite of Denial
Runic Headgear	Runeblast
Runt Spear	Runts of the Litter
Rusted Chestplate	Leeching Burrower
Rusty Chestplate	Optimatron
Rusty Knuckles	Nature Reigns
Sabatons of Lumos	Inquisitor of Lumos
Saboteur's Face Mask	Inventive Saboteur
Sabotons of Madness	Morsel of Madness
Sacred Stiletto	Chlorophyllia
Sacred Stone Staff	Monk of the Sacred Stones
Sacred Stones	Glimmerfly Dance
Sacrelegious Robes	Profane Ritualist
Sacrificial Blade of the Cabalist	Exalted Cabalist
Sadistic Stompers	Cruel Sentence
Safety Gloves	Cleanup Project
Sage's Vestments	Eternal Sage
Sample Gauntlets	Detox Bot
Samurai Kabuto	Hop'hiro, Samurai
Sanctuary Shoes	Jorgen's Workshop
Sanctuary Spade	Shoku's Garden
Sandals of Fealty	Spearcliff Cloud Knight
Sandals of the Martyr	Martyr
Sapper's Boots	Sapper's Charge
Saurian Gauntlets	Jadiim
Savage Headdress	Bellow of Briggadon
Savvas Absurdity Vest	Savvas' Evocation
Scale of Juurdin	Juurdin
Scaled Gloves	Zeedu
Scaly Cap	Chomposaur
Scarecrow's Scythe	Stingy Jack
Scavenger Club	Grave Nibbler
Scepter of Nightmares	Inner Conflict
Scepter of the Ancients	Vengeance of the Ancient Kings
Schemer's Hide	Illusionary Schemer
Scheming Mitts	Illusionary Schemer
Scorched Breastplate	Mentor of the Flames
Scorpio Aculeus	Sting of the Scorpinox
Scorpio Greaves	Spontaneous Combustion
Scorpio Pincers	Scorpinox
Scout's Brooch	Nazhk Lookout
Scout's Crossbow	Dawn Scout
Scout's Headband	Mesa Lookout
Scout's Shield	Strider Scout
Scrap Metal Plate	Scrap the Endless
Scrap Metal Shoes	Magnetize
Scrap Shooter	Scrapyard Recyclatron
Scrapyard Waders	Scrapyard Bruiser
Scrounged Flail	Nazhk Scrounger
Scrounger Gauntlets	Nazhk Scrounger
Scutt's Wire Puller	Scutt's Sparker
Scuttletux	Scuttlecrux
Scythe of the Stalker	Stalker of Marbaras
Seafaring Gloves	Drag to the Depths
Seaguard Helm	Kraken Guard Mariner
Searing Sword	Pyreblade Slicer
Seer's Regalia	Thunderfield Seer
Seismic Charge	Seismic Pounder
Self Sustaining Bucket	Hex Battery
Sepulcher's Blessing	Rise Again
Sepulchra Cuirass	Sepulchra Stalwart
Sepulchra Scarab	Sepulchra Maggot
Sepulchra Spinneret	Sepulchra Fleshreaver
Sepulchra Stone Sledge	Sepulchra Maggot
Seraph's Heart	Bastion of Adamanth
Serenity Hood	Prophet of Lodegan
Serf Clogs	Moshpit Gladiator
Servo Grips	Servo Slingshot
Servo Piston Fist	Servo Servant
Sewn Sigil Gloves	Sporeshambler
Shadow Ambush Hood	Horrific Poltergeist
Shadow Garrote	Butcher
Shadow Gloves	Darkspire Tyrant
Shadowtail Chalice	Shadowtail Rider
Shamrock's Gold Vest	Shamrock, The Goldfather
Shank	Bleak Bladetwister
Shard of Tiaanost	Tiaanost
Shard of Zakiir	The Wrath of Zakiir
Shard Stone Ring	Compulsive Gambler
Shardcaller's Necklace	Shardcall
Shawl of Vaelena	Seamstress of Vaelena
Shell on Wheels	Wolsy Wabbit
Shield of Illumination	Brightflame Paladin
Shiitake Shiv	Freaky Fungus
Shin'gami Sandals	Shin'gami
Shiny Cog	Mecha Filk Ape
Shocker Attachment	Reactor Bot
Shoes of Disgrace	Shamed Gladiator
Shoes of Divine Foresight	Zodiac Divination
Shogun's Curved Dagger	Monsuun, Shogun of Winda'jin
Shroom Boom	Boom Shroom
Shroom Mask	Shroomshaw
Shroom Swarm Seashore Shoes	Shroom Swarm
Shroud of Shadow	Shroud
Sickle of the Mistlord	Mistlord
Sidearm	Jet Cadet
Siegesaurus Hyde Gloves	Siegesaurus
Sight Shift Mask	Lanupaw's Sight
Sigil of Grace	Righteous Paladin
Sigil of Mostugh	Optimatron
Sigil of the Bleeding Cut	Throat Cutter
Sigil of the Triumvirate	Lord Adam, the Powerful
Signet of the Sword	Daring Swordsman
Silent Strike Armor	Spectral Assassin
Silk Fang Bow	Zilth
Silk Glove of the Unseeing	Sentinel of Nulzann
Silk Gloves of Starsight	Starsight Oracle
Silk Hardened Carapace	Zilth
Simple Heart of Solidarity	Alwyn
Singing Adornment	Song of the Sun
Sinister Cloak	Skulk of the Wastes
Sinister Stalkers	Skulk of the Wastes
Skarn Tail Skullguard	Skittering Skarn
Skarnskin Footwraps	Luminarie Kindler
Skeletal Kris	Furious Smasher
Skin Worn Delvers	Necrophage Sensei
Skindeep Infusion Device	Inkheart Infuser
Skittering Hood	Ushul
Skull Frenzy Charm	Zakiir's Frenzy
Sky Walkers	Water Elemental
Sky Watchers	Auspex of Lanupaw
Sky'le Blade	Sky'le Griffin
Skydancer Shoes	Skydancer
Skyhunter Gloves	Lightning Skyhunter
Skylancer's Breastplate	Skylance Captain
Skyshaper Paws	Typhoon Skyshaper
Skyward Robes	Cerulean Sky Mage
Slashmouth	Ballistar
Slaughtergear's Advanced Technology	Slaughtergear's Replicator
Slaughtergear's Crossbow	Slaughtergear's Reaver
Slaughtergear's Electric Gauntlet	Slaughtergear's Guardians
Slayer Trainer Goggles	Loregoyle Curator
Sling Stone Sleeve	Stingshot Sniper
Slippers of Devouring	Soul Devour
Slippers of Diversion	Distract
Slippers of Intellect	Sapphire Aura
Slippers of the Cloud Queen	Cloud Queen
Slippers of the Skirmisher	Graveblade Skirmisher
Slippers of the Witching Hour	Midnight Convergence
Smiter's Bracers	Ashwood Smiter
Smoke Bomb	Conceal
Smokeclaw Sai	Smokeclaw Raker
Snakeskin Boots	Vampython
Snakeskin Sandals	Genesis Hydra
Snatch and Vermin	Mindsnatch Raven
Snazzy Shoes	Reality Rift
Sneaky Garment	Sneakblade of the Milky Eye
Sneaky Sneakers	Darkspire Acolyte
Snicker Snack	Vorpus
Sniper's Arc	Monsagi Sniper
Sniper's Slippers	Rot Sniper
Snug Scale Slippers	Saarthu
Solebare Boots	Relentless Zombie
Soloist's Suit	Ashwood Soloist
Something Opaque	Something Borrowed
Song of the Ancestors	Oracle Song
Songbird Shoes	Cheery Songbird
Songstress's Lyre	Feralroot Songstress
Soul Buckled Gloves	Soulblade Samurai
Soul Carver	Soul Slaver
Soul Harvester	Harvest of Sorrow
Soul Touch Tachi	Soul of Raqqar
Soulcage	Courageous Soul
Soulcurser's Crown	Ryaalinth the Soulcursed
Soulrage Helm	Blood Cauldron Ritualist
Soulsteal Bracers	Soul Devour
Soup Stirrers	Shiitake Chef
Sous Chef Slippers	Shiitake Chef
Sovreign Sky Stalkers	Vaarician
Spark Mitts	Water Elemental
Sparkle Staff	Uncle Sparklestaff
Sparklestaff's Robe	Uncle Sparklestaff
Sparrowrider's Crossbow	Phoenix Guard Scout
Spear of the Crater Guard	Mazat Spearman
Spectral Ambush Boots	Spirit of Retribution
Spellcaster's Tunic	Refute
Spellstone Tunic	Spellstone Gargoyle
Spellstorm Striders	Spellstorm Titan
Spider Band	Goliath Spiderspawn
Spider Crown	Nazhk Lookout
Spider Fang	Parriphagy
Spiderspawn Breastplate	Giant Spiderspawn
Spiked Diggers	Excavation Bot
Spirit Depleters	Soul Siphoner
Spirit Eagle Feather	Spirit Eagle
Spirit Filled Decanter	Soul Siphoner
Spirit Flame Fingers	Pyresoul Summoner
Spirit Flame Staff	Pyresoul Magistrate
Spirit Strike Scarf	Spirit of Retribution
Spiritbound Robes	Spiritbound Vicar
Spiritbound Slippers	Spiritbound Spy
Spiritcaller Breastplate	King Lodegan's Call
Spiritlash	The Fate Rack
Spiritscourge Ring	Mistborn Wendigo
Spiritual Slippers	Lady Devonshire
Spiritualist Sandals	Rhythmic Spiritualist
Spiteful Adornment	Inquisitor's Spite
Splinter Spore Gloves	Splinterslam
Splintered Cudgel	Splinterslam
Splintered Touch	Sliver of the Immortal Spear
Spore Ball Hightops	Captured Flag
Spore Shine Shoots	Sporeshambler
Spring Litter Striders	Feeding the Young Ones
Spring-Loaded Action Treads	War Bot Dropship
Spritegang Spellbook	Arcane Spritegang
Sprouting Laureat	Royal Den Mother
Stabilizing Boots	Scrap Welder
Stabilizing Pocket Watch	Reality Rift
Staff of Defiance	Defiant Totemist
Staff of Ice	Hoarfrost Magus
Staff of Oberon	Oberon's Eulogy
Staff of the Brood Priest	Phenteo the Brood Priest
Staff of the Orchin	Orchi-noko
Stainless Steel Popper	Replipopper 4000
Stalactunic	Stalagmage
Stalker's Blood Boots	Stalker of Marbaras
Stallion Plate	Spearcliff Cavalier
Stance Shoes	Sacred Stance
Standard Issue Helmet	Underworld Reinforcements
Standard Issue Stompers	Underworld Reinforcements
Star Woven Robes	Startouched Watcher
Stardust Vial	Zodiac Crowfeather
Starlight Grips	Starlight Shaman
Starmend Moccasins	Wakuna Starmender
Starmender's War Bonnet	Wakuna Starmender
Staunch Breastplate	Devout Crusader
Steady Eddy Boots	Tidal Eddy
Steam Engine Inspectacles	Mimeobot
Steed Whip	Blight Steed
Steel Treads	Form Ranks
Stifling Handwraps	Stifling Sting
Stinger of Mutation	Nox Animist
Stink Blade	Stinkhorn Soup
Stink Boots	Stink Troll
Stolen Crown	Fiendish Cabalist
Stompers of Calamitous Intent	Walking Calamity
Stopgap Brainwasher	Neophyte of Xarlox
Stormcoat	Storm of the Century
Stormstrike Gauntlets	Cerulean Sky Mage
Stormwing Breastplate	Stargazer
Suede Shockers	Pulse Reactor
Suffocating Choker	Suffocate
Sultry Shell	Heat Wave
Summoner's Hauberk	Darad, the Scourgeblade
Sun Song Jersey	Song of the Sun
Sunlit Scribe	Sunlit Sentence
Sunset Cap	Sunset Shade
Sure Shot Coat	Shellsafe Sure Shot
Surge Boots	Withering Touch
Surge Plate	Deadeye Charger
Surging Fur Coat	Surging Squirrel Titan
Surging Steel Blade	Surging Squirrel Titan
Surly Slippers	Surly Brawler
Swamp Walkers	Bog Walker
Swarm Strapped Steppers	Piranha Swarm
Swarming Fingers	Nibblin Swarm
Swashbuckler's Foil	Reginald Lancashire
Sweep Cleats	Broom Bot
Sweet Duster	Brewmaster Buzzlebeard
Sweet Hat	Gnome Wayfarer
Swift Breeze Visor	Vanguard of Cerulea
Swift Slicer	Deadeye Slicer
Sword of Sapphires	Storm Colossus
Sworddancer's Limp	Buccaneer
Sylvan Sounder	Sylvan Performer
Sylvan Storm Slippers	Sylvan Springs
System of Nulzann	Animus of Nulzann
Tabard of Lyvaanth	Lyvaanth's Claw
Tablet of the Revenant	Call the Grave
Tabula Rasa	Locke of the Pack
Tainted Teacup	Polyberry Pouch
Talisman of Juurdin	Juurdin
Tanko of Terror	Sora
Tanned Piglet Vest	Feral Squeaker
Tantalizing Tiara	Tantalizing Naiad
Targe of Darkness	Night Warden
Tarot Handlers	Cartomancy
Taskmaster Blade	Fungal Monstrosity
Technografters Boots	Arcanograft Technician
Telepath's Helm	Mind Games
Temporal Treads	Temporal Exile
Ten-Zinnia Tincture	Darkfall Patriarch
Tenacious Katana	Nori
Tender Green Gloves	The Buffalord
Tentacled Fingers	Slithering Marauder
Terror Tined Tunic	Phenteo's Gift
Terror Touched Blade	Phenteo's Gift
The Arthropod's Cube	Giant Army Ants
The Calling Blade	Pack Raptor
The Decapitator	Gruesome Deed
The Dingler's Hood	Polymorph: Dingler
The Goldfather's Ring	Shamrock, The Goldfather
The Guillotine	Execute
The Harbinger	Malice Demon
The Infiltrator	Infiltrate
The Manipulator's Mantle	Uruunaz
The Mirrorblade	Replicator's Gambit
The Nimomancer's Cloak	Nimomancer
The Null Veil	Void Star's Gaze
The Randomly Sorting Hat	Apprentice Trio
The Spider's Lure	Brood Creeper
The Storm Icon	Stargazer
The White Heart	Diamond Aura
Thicket Creepers	Bramble Creeper
Thistlecloak	Bramble Creeper
Thorn Emblazoned Gauntlets	Herald of Thorns
Thorn Knuckler	Thornsprout
Thorn Quiver	Vine Lash
Thorntwist Thumb	Thorntwister
Thorntwisted Crown	Blightbush
Thornweaved Tunic	Thorn Weaver
Thought Accelerator	Junk Repurposer
Thought Enhancer	Mind Games
Thought Provoker	Epiphany
Thought Seeker	Flamethought Seeker
Three-Fingered Gloves	Forgotten Triolith
Throwback Jersey	Throwback
Thug Topper	Surprise Runt Gang
Thunderbolt Helm	Thunderbolt Warden
Thundering Bow	Menacing Gralk
Thunderstrike Chestguard	Thunderbird
Tiaanost's Raiments	Grace of Tiaanost
Tiara of Visions	Elder of Visions
Tidal Boots	Crackling Tide
Tide Galoshes	Hardshell Guardclaw
Timepiercing Javelin	Time Ripple
Timescale Breakers	Twilight Eclipse
Timophy's Gameboard	Kismet's Dice
Tinker Fingers	Restless Fabricator
Tinkerer's Robes	War Machinist
Titan's Jar	Titan of Voktar
Toad Juice	Dire Toad
Tomb Rot Boots	Force of the Tomb
Tomb Waders	Voice of Tombs
Tombskin Hands	Sealed Tomb
Tome of the Vision Quest	Vision Quest
Tome of the Warden	Zakiir
Toolbox Glove	Junk Repurposer
Tormenting Boots	Crackling Torment
Tormentor's Spear	Hatchery Tormentor
Torrential Trodders	Hailstorm
Totem Crush Maul	Mesa Totemist
Touch of Grace	Her Majesty, Queen Grace
Touretic Rune Raiment	Runefusion
Toxic Whip	Scourgecrag Witch
Training Vest	Born to Die
Transonic Screwdriver	Hex Engine
Trapper Grips	Vine Trap
Traveling Slippers	Lord Bernard P. Dunthorpe
Treads of Advent Dawn	Daybreak
Treads of Degradation	Rot Caster
Treads of Frost	Frostmare
Treads of the Exalted	Exalted Knight
Treeguard Barkplate	Nelebrin Treeguard
Trench Knife	Deathmask Ravager
Tribal Warcaller	Tribal Warfare
Trickster's Gloves	Prospero, Sylvan Enchanter
Trinket of Duty	Glyph of Duty
Trinket of Ferocity	Glyph of Ferocity
Trinket of Hatred	Glyph of Hatred
Trinket of Primordium	Glyph of Primordium
Trinket of Sky	Glyph of Sky
Troika Blades	Forgotten Triolith
Troll Headcover	Puke Troll
Trunk of the Wild Ancient	Lumbering Sparklespore
Tunic of the Conjuror	Briarpatch Conjuror
Turbine Gloves	Dwarven Turbine
Turgid Gloves	Growth Potion
Turn Signal	Wrong Turn
Turtle Shell Bulwark	Dream Turtle
Twilight Crown	Twilight Archon
Twilight Scaled Greaves	Scales of Twilight
Twilight Scout Gloves	Twilight Scout
Twilight Visor	Twilight Watcher
Twin Feather Hands	Royal Stork
Twinkle Twinkle Little Star	Lullaby
Twisted Shuriken	Crackling Bolt
Ugly Sweater	Pappy Jasper
Umbra Gauntlets	Umbral Guard
Umbrella of the Cloud King	Cloud King
Underworld Hacker	Underworld Crusader
Unflinching Breaker	Bucktooth Commander
Unfortunate Inheritance	Righteous Heir
Unhenged Haurberk	Unhenge
Unholy Aegis	Deepgaze Champion
Universal Lexicon	
Unliving End	Bitter Dread
Unnecessary Extra Armament	Mega-Bot 9000
Unowned Boots	Eldritch Shriek
Unstable Induction Rapier	Inductocopter Bot
Vampire's Crown	Vampire Princess
Vampiric Blessing	Cleave
Vampiric Cape	Enthralling Gaze
Vandal Blast Bracers	Vandalize
Vanguard's Gloves	Nelebrin Vanguard
Vaporizer	Evaporate
Veil of Fortune	Cartomancy
Veiled Chestguard	Veiled Lurker
Venom Blade	Rizzix
Venom Boots	Brood Creeper
Venomous Cleaver	Dark Pact Demon
Verdant Blade	Verdant Chant
Vest of Fecundity	Rotting Buffalo
Vest of the Ruminant	Dream Stag
Vestments of Acumen	Mindcaller
Vestments of Atonement	Angel of Atonement
Veteran's Halberd	Veteran Raider
Vial of Dragon's Blood	Tome of Uruunaz
Vial of Fecundity	Fertile Engorger
Vial of Weak Sauce	Cull the Weak
Victim's Memento	Drag to the Depths
Vile Defender Chestcage	Vilestrain Cultivator
Vile Mask	Defiler of the Fallen
Vile Stompers	Vilefang Eremite
Viridian Footwear	Viridian
Visage of the Brood	Wretched Brood
Visor of the Gatekeeper	Sophro's Gatekeeper
Voidstone Blade	Chaotic Rip
Voltaic Handguards	Charge Bot
Voltdealer Dirk	Voltwrench
Voodoo Vest	Corrupted Afterlife
Voyagers Grips	Nameless Pact
Vulture Claw	Zombie Vulture
Wand of Privilege	Noble Citizenry
Wand of Webulation	Woeful Webbing
Warden's Ward	Moonwarden
Warding Wand	Brilliant Ward
Warforged Battleplate	Warforged Slayer
Warforged Spear	Warforged Slayer
Warglaive of Light	Lux Guard
Warhammer of Smiting	Militant Paladin
Warlock's Footsteps	Blades of Bone
Warlock's Whip	Swampwater Recluse
Warm Spellbox	Volley
Warp Gloves	Time Wave
Warp Pebble	Warp Stone
Warped Boots	Warp Stone
Waste Bin	Sweep Away
Watch of the Witching Hour	Midnight Hour
Wax Doffed Cap	Wax Dawn
Waxed Warplate	Lumiknight
Waxed Wingtips	Lyvaanth
Weapon of Choice	Contract Killing
Web Knit Miter	Priest of the Sacred Web
Webbed Helm of Fear	Arachnophobia
Webbed Wrists	Webshot Sniper
Webguard's Gauntlets	Nazhk Webguard
Websong Gloves	Incubation Slave
Webstuck Sabotons	Woeful Webbing
Welder's Ruin Mask	Junk Welder
Well Shoed Army	Wailing Rider
Wellspring Harp	Wellspring
Whisper Taker	Moment of Glory
Whistle Wraps	Dynamo Whistle
White Carapace	Winter Widow
White Hat of the Sorcerer	Mindwrack Sorcerer
Widget	Mesmeric Chant
Wig of the Magistrate	Timestep Magistrate
Wiktor's Spoil	Captured Flag
Wiley Chest	Halt
Will of the Dragon	The Wrath of Zakiir
Wind Charm Gloves	Cyclone Rider
Wind Throwers	Mentor of the Wind
Wind Walkers	Windspeaker
Windup Widget	Warpsteel Widget
Wing Brushed Gauntlets	Guardian Angel
Winged Alloy Helm	Pterobot
Winged Walkers	Lightning Brave
Winter Coat	Blizzard
Winter Hat	Chilltail Guide
Winter Storm Guards	Vexstorm
Wisdom's Band	Angel of Foresight
Wishy Wand	Witch of the Wishing Well
Wooden Bident	Nerissa
Woodland Sandals	Gossamer Tears
Wrathwood Mitts	Wrathwood Colossus
Wreath of Thorns	Moldmass
Wrenlocke's Chestplate	Archmage Wrenlocke
Writer's Guard	Decree of Banishing
Wyldeboots	Stampeding Wyldeboar
Wyldebracers	Stampeding Wyldeboar
Wyrmskin Sandals	Lorenzo the Wyrmsinger
Xocoy's Double-bladed Axe	Xocoy, High Cleric
Yellow Sign Cowl	Gaze of Hastur
Yeti Bustier	Mama Yeti
Yeti Motivator	Chained Peak Yeti
Yetiproof Skullcage	Yetigeddon
Yule Log	Yule Tide
Zealot's Skull	Brutal Commander
Zoltog's Chestplate	Zoltog
